726  1  8:  HO004  1 7
726  1  7:  HO004  1 6
726  4  7:  HO004  1 4
726  1  6:  HO004  2 7
726  1  5:  HO004  2 6
726  4  6:  HO004  2 4
726  1  4:  HO004  3 7
726  1  3:  HO004  3 6
726  4  8:  HO004  3 4
726  9  8:  HO005  1 7
726  9  7:  HO005  1 6
727  0  7:  HO005  1 4
727  1  2:  HO1M06 2 3
727  2  4:  HO1M06 2 5
727  2  8:  HO1M06 2 7
726  9  6:  HO005  2 7
727  2  2:  HO1M06 2 2
727  2  6:  HO1M06 2 4
727  3  2:  HO1M06 2 6
726  9  5:  HO005  2 6
727  0  6:  HO005  2 4
726  9  4:  HO005  3 7
727  1  1:  HO1M06 4 3
727  2  3:  HO1M06 4 5
727  2  7:  HO1M06 4 7
726  9  3:  HO005  3 6
727  0  8:  HO005  3 4
727  2  1:  HO1M06 4 2
727  2  5:  HO1M06 4 4
727  3  1:  HO1M06 4 6
727 10  2:  HO1M06 3 2
727 10  6:  HO1M06 3 4
727 11  2:  HO1M06 3 6
727  9  2:  HO1M06 3 3
727 10  4:  HO1M06 3 5
727 10  8:  HO1M06 3 7
727 10  1:  HO1M06 1 2
727 10  5:  HO1M06 1 4
727 11  1:  HO1M06 1 6
727  9  1:  HO1M06 1 3
727 10  3:  HO1M06 1 5
727 10  7:  HO1M06 1 7
728  1  8:  HO007  4 2
728  1  7:  HO007  4 3
728  4  7:  HO007  4 5
728  5  2:  HO1M08 2 3
728  6  4:  HO1M08 2 5
728  6  8:  HO1M08 2 7
728  7  4:  HO2M08 4 3
728  7  8:  HO2M08 4 5
728  5  6:  HO2M08 4 7
728  1  6:  HO007  3 2
728  6  2:  HO1M08 2 2
728  6  6:  HO1M08 2 4
728  7  2:  HO1M08 2 6
728  7  6:  HO2M08 4 2
728  5  4:  HO2M08 4 4
728  5  8:  HO2M08 4 6
728  1  5:  HO007  3 3
728  4  6:  HO007  3 5
728  1  4:  HO007  2 2
728  5  1:  HO1M08 4 3
728  6  3:  HO1M08 4 5
728  6  7:  HO1M08 4 7
728  7  3:  HO2M08 2 3
728  7  7:  HO2M08 2 5
728  5  5:  HO2M08 2 7
728  1  3:  HO007  2 3
728  4  8:  HO007  2 5
728  6  1:  HO1M08 4 2
728  6  5:  HO1M08 4 4
728  7  1:  HO1M08 4 6
728  7  5:  HO2M08 2 2
728  5  3:  HO2M08 2 4
728  5  7:  HO2M08 2 6
728  9  8:  HO008  1 7
729  2  2:  HO1M08 3 2
729  2  6:  HO1M08 3 4
729  3  2:  HO1M08 3 6
729  3  6:  HO2M08 1 2
729  1  4:  HO2M08 1 4
729  1  7:  HO2M08 1 6
728  9  7:  HO008  1 6
729  0  7:  HO008  1 4
729  1  2:  HO1M08 3 3
729  2  4:  HO1M08 3 5
729  2  8:  HO1M08 3 7
729  3  4:  HO2M08 1 3
729  3  8:  HO2M08 1 5
729  1  6:  HO2M08 1 7
728  9  6:  HO008  2 7
728  9  5:  HO008  2 6
729  0  6:  HO008  2 4
729  2  1:  HO1M08 1 2
729  2  5:  HO1M08 1 4
729  3  1:  HO1M08 1 6
729  3  5:  HO2M08 3 2
729  1  3:  HO2M08 3 4
729  1  8:  HO2M08 3 6
728  9  4:  HO008  3 7
729  1  1:  HO1M08 1 3
729  2  3:  HO1M08 1 5
729  2  7:  HO1M08 1 7
729  3  3:  HO2M08 3 3
729  3  7:  HO2M08 3 5
729  1  5:  HO2M08 3 7
728  9  3:  HO008  3 6
729  0  8:  HO008  3 4
729  5  8:  HO009  1 7
729  5  7:  HO009  1 6
729  8  7:  HO009  1 4
729  5  6:  HO009  2 7
729  5  5:  HO009  2 6
729  8  6:  HO009  2 4
729  5  4:  HO009  3 7
729  5  3:  HO009  3 6
729  8  8:  HO009  3 4
731  3  4:  HO2M12 4 3
731  3  8:  HO2M12 4 5
731  1  6:  HO2M12 4 7
731  3  6:  HO2M12 4 2
731  1  4:  HO2M12 4 4
731  1  8:  HO2M12 4 6
731  3  3:  HO2M12 2 3
731  3  7:  HO2M12 2 5
731  1  5:  HO2M12 2 7
731  3  5:  HO2M12 2 2
731  1  3:  HO2M12 2 4
731  1  7:  HO2M12 2 6
731  5  8:  HO012  1 7
731 11  6:  HO2M12 1 2
731  9  4:  HO2M12 1 4
731  9  7:  HO2M12 1 6
731  5  7:  HO012  1 6
731  8  7:  HO012  1 4
731 11  4:  HO2M12 1 3
731 11  8:  HO2M12 1 5
731  9  6:  HO2M12 1 7
731  5  6:  HO012  2 7
731  5  5:  HO012  2 6
731  8  6:  HO012  2 4
731 11  5:  HO2M12 3 2
731  9  3:  HO2M12 3 4
731  9  8:  HO2M12 3 6
731  5  4:  HO012  3 7
731 11  3:  HO2M12 3 3
731 11  7:  HO2M12 3 5
731  9  5:  HO2M12 3 7
731  5  3:  HO012  3 6
731  8  8:  HO012  3 4
725  8  2:  HO1P04 2 3
725  7  6:  HO1P04 2 5
725  7  2:  HO1P04 2 7
725  6  6:  HO2P04 2 3
725  6  2:  HO2P04 2 5
725  4  2:  HO2P04 2 7
725  7  8:  HO1P04 2 2
725  7  4:  HO1P04 2 4
725  6  8:  HO1P04 2 6
725  6  4:  HO2P04 2 2
725  4  4:  HO2P04 2 4
729 12  6:  HO2P04 2 6
725  8  1:  HO1P04 4 3
725  7  5:  HO1P04 4 5
725  7  1:  HO1P04 4 7
725  6  5:  HO2P04 4 3
725  6  1:  HO2P04 4 5
725  4  1:  HO2P04 4 7
725  7  7:  HO1P04 4 2
725  7  3:  HO1P04 4 4
725  6  7:  HO1P04 4 6
725  6  3:  HO2P04 4 2
725  4  3:  HO2P04 4 4
729 12  7:  HO2P04 4 6
726  1  2:  HO004  1 3
726  4  3:  HO004  1 5
726  3  8:  HO1P04 3 2
726  3  4:  HO1P04 3 4
726  2  8:  HO1P04 3 6
726  2  4:  HO2P04 3 2
726  0  4:  HO2P04 3 4
729 13  3:  HO2P04 3 6
726  1  1:  HO004  1 2
726  4  2:  HO1P04 3 3
726  3  6:  HO1P04 3 5
726  3  2:  HO1P04 3 7
726  2  6:  HO2P04 3 3
726  2  2:  HO2P04 3 5
726  0  2:  HO2P04 3 7
726  0  8:  HO004  2 3
726  4  4:  HO004  2 5
726  0  7:  HO004  2 2
726  3  7:  HO1P04 1 2
726  3  3:  HO1P04 1 4
726  2  7:  HO1P04 1 6
726  2  3:  HO2P04 1 2
726  0  3:  HO2P04 1 4
729 13  2:  HO2P04 1 6
726  0  6:  HO004  3 3
726  4  5:  HO004  3 5
726  4  1:  HO1P04 1 3
726  3  5:  HO1P04 1 5
726  3  1:  HO1P04 1 7
726  2  5:  HO2P04 1 3
726  2  1:  HO2P04 1 5
726  0  1:  HO2P04 1 7
726  0  5:  HO004  3 2
726  9  2:  HO005  1 3
727  0  3:  HO005  1 5
726  9  1:  HO005  1 2
726  8  8:  HO005  2 3
727  0  4:  HO005  2 5
726  8  7:  HO005  2 2
726  8  6:  HO005  3 3
727  0  5:  HO005  3 5
726  8  5:  HO005  3 2
728  1  2:  HO007  4 6
728  4  3:  HO007  4 4
728  1  1:  HO007  4 7
728  0  8:  HO007  3 6
728  4  4:  HO007  3 4
728  0  7:  HO007  3 7
728  0  6:  HO007  2 6
728  4  5:  HO007  2 4
728  0  5:  HO007  2 7
728  9  2:  HO008  1 3
729  0  3:  HO008  1 5
728  9  1:  HO008  1 2
728  8  8:  HO008  2 3
729  0  4:  HO008  2 5
728  8  7:  HO008  2 2
728  8  6:  HO008  3 3
729  0  5:  HO008  3 5
728  8  5:  HO008  3 2
729  5  2:  HO009  1 3
729  8  3:  HO009  1 5
729  5  1:  HO009  1 2
729  4  8:  HO009  2 3
729  8  4:  HO009  2 5
729  4  7:  HO009  2 2
729  4  6:  HO009  3 3
729  8  5:  HO009  3 5
729  4  5:  HO009  3 2
731  5  2:  HO012  1 3
731  8  3:  HO012  1 5
731  5  1:  HO012  1 2
731  4  8:  HO012  2 3
731  8  4:  HO012  2 5
731  4  7:  HO012  2 2
731  4  6:  HO012  3 3
731  8  5:  HO012  3 5
731  4  5:  HO012  3 2
